IY neighbors: IY|IH|IX
IH neighbors: IH|IY|AX|EH
EH neighbors: EH|IH|AX|ER|AE
AE neighbors: AE|EH|ER|AH
AH neighbors: AH|AE|ER|AA
AA neighbors: AA|AH|ER|AO
AO neighbors: AO|AA|ER|AX|UH
UH neighbors: UH|AO|AX|UW|UW
UW neighbors: UW|UH|AX|UW
UW neighbors: UW|IX|AX|UH|UW
IX neighbors: IX|IY|IH|AX|UW
AX neighbors: AX|IX|ER|UW
ER neighbors: ER|EH|AH|AO|AX
EY neighbors: EY|EH|IY|AY
OY neighbors: OY|AO|IY|AY
AY neighbors: AY|AA|IY|OY|EY
AW neighbors: AW|AA|UH|OW
OW neighbors: OW|AO|UH|AW
[I]Y+UW neighbors: [I]Y+UW|IY|UH|IX|UW
P neighbors: P|T|B|HH
T neighbors: T|CH|K|D|P|HH
CH neighbors: CH|SH|JH|T
K neighbors: K|G|T|HH
SH neighbors: SH|S|ZH|CH
S neighbors: S|SH|Z|TH
B neighbors: B|P|D
D neighbors: D|T|JH|G|B
JH neighbors: JH|CH|ZH|D
G neighbors: G|K|D
ZH neighbors: ZH|SH|Z|JH
Z neighbors: Z|S|DH|ZH
TH neighbors: TH|S|DH|F|HH
F neighbors: F|HH|TH|V
DH neighbors: DH|TH|Z|V
V neighbors: V|F|DH
HH neighbors: HH|TH|F|P|T|K
L neighbors: L|R|W
R neighbors: R|Y|L
Y neighbors: Y|W|R
W neighbors: W|L|Y
M neighbors: M|N
N neighbors: N|M|NG
NG neighbors: NG|N
M-AX? neighbors: M-AX?|AX|N-{A,I}X?
N-{A,I}X? neighbors: N-{A,I}X?|AX|M-AX?
L-{A,I}X? neighbors: L-{A,I}X?|AX|ER
DX neighbors: DX|DX|S|HH|DH
DX neighbors: DX|DX|T
N neighbors: N|AX|M|NG
